{
  "level_map": [0, 0, 0, 0, 0, 3, 3, 0, 0,
                0, 0, 0, 0, 3, 0, 0, 3, 0,
                0, 0, 0, 3, 0, 0, 0, 3, 0,
                0, 0, 2, 1, 2, 0, 0, 3, 0,
                0, 2, 1, 1, 1, 2, 0, 0, 0,
                0, 2, 1, 1, 1, 2, 0, 0, 0,
                0, 2, 1, 1, 1, 2, 0, 0, 0,
                0, 2, 1, 1, 1, 2, 0, 0, 0,
                0, 0, 2, 2, 2, 0, 0, 0, 0],
  "level_map_properties":
  [
    {
        "indexes": [21],
        "attribute_boost_name": "ColorChainBomb"
    }
  ],
  "rows": 9,
  "columns": 9
}